_ _ _ _ _ _ _ _ _ _
_ _ _ _ _ _ _ _ _ _
_ _ 1 _ _ _ _ _ _ _
_ _ _ _ x x _ c _ _
_ _ A _ _ _ _ b _ _
_ _ B _ o o _ a _ _
_ _ C _ _ _ _ _ _ _
_ _ _ _ _ _ _ 2 _ _
_ _ _ _ _ _ _ _ _ _
_ _ _ _ _ _ _ _ _ _
