_ _ _ _ _ _ _ _ _ _
_ _ _ _ _ 1 _ _ _ _
_ _ _ _ _ _ _ _ _ _
_ _ B _ _ A _ _ _ _ 
_ _ _ o x _ o _ _ _ 
_ _ _ x a _ _ b _ _
_ _ _ _ _ _ _ _ _ _
_ _ _ _ _ _ _ _ _ _
_ _ 2 _ _ _ _ _ _ _
_ _ _ _ _ _ _ _ _ _
