9
9
100
100
o x x x x x x x o
o x o x b o o x o
o x x _ _ x o x o
o _ o _ 1 a 2 x o
o _ _ B _ o x c o
o _ x o A x o _ o
o _ _ _ x _ _ _ o
o x o C _ _ o o o
o o o o o o o o o