9
9
33
40
o o o o o o o o o
o o _ o o o c o o
o b _ x o _ A x o
o o _ _ _ 1 _ o o
o o o x 2 x o o o
o o x _ _ a x o o
o _ B _ o _ _ _ o
o o _ x o x C x o
o o o o o o o o o