9
8
100
100
o o o o o o o o o
o x o x c x o x o
o o _ o A B C _ o
o _ 2 b _ _ 1 _ o
o a o _ o _ o o o
o _ _ _ _ _ _ o o
o _ _ _ x _ _ o o
o o o o o o o o o