9
9
100
100
x x x x x x x x x
x _ _ _ _ C o _ x
x _ _ _ _ _ _ _ x
x _ o _ 1 A _ _ x
x _ _ _ a x _ _ x
x _ _ o 2 _ B _ x
x _ _ _ _ _ _ _ x
x c _ _ b o _ _ x
x x x x x x x x x