9
8
16
20
o o x o o o o o o
o x _ o o o o o o
x _ _ x o x o o o
x o 1 A _ b x o o
x o a x _ _ B _ o
x 2 _ x o x o o o
x _ _ o o o o o o
o o x o o o o o o