8
9
30
40
o o o o o x o o
o o _ _ _ _ 2 o
o o a o _ 1 _ x
o o A o o _ _ o
o _ _ _ o o _ o
o _ _ _ _ _ _ o
o _ _ _ _ _ _ o
o b _ _ _ o o o
o o o o o o o o