10
8
100
100
o o o o o o o o o o
o o x _ x x _ _ c o
o B x _ x _ x _ _ o
o b A 2 a 1 x _ _ o
o _ x x x _ x C _ o
o _ _ _ _ x _ _ x o
o _ _ _ _ _ _ x _ o
o o o o o o o o o o