8
9
29
37
o o o o o o o o
o c _ _ _ o o o
o _ _ _ _ o o o
o _ o o _ o o o
o _ x o a o o o
o _ 2 x 1 b x o
o x _ A _ B _ o
o o _ _ _ o o o
o o x x o o o o