11
7
8
10
o o o o o o o o x o o
o _ _ _ _ _ _ _ _ _ o
o _ _ _ _ 1 A _ _ o o
o o o x 2 _ _ x o o o
o _ _ _ _ _ _ o o o o
o a o _ _ _ _ o o o o
o o o o o o o o o o o