9
9
37
50
o o o o o o o o o
o _ _ _ o x _ x o
o _ x _ _ _ _ _ x
o _ _ 1 b x _ x o
o o a o C o A o o
o _ _ _ B x _ 2 o
o _ x _ _ _ x _ o
o _ x _ c _ _ _ o
o o o o o o o o o