7
7
19
22
o o o x o o o
o o _ A x o o
o B o _ o x o
x _ a 1 _ 2 x
o x o _ o b x
o o x _ _ x o
o o o x x o o