9
9
100
100
o o o o o o o o o
o 2 _ _ o _ _ _ o
o _ x _ o _ _ _ o
o _ _ a A _ _ 1 o
o o o B x _ o x o
o _ _ b C c _ _ o
o _ _ _ o _ _ _ o
o _ _ _ o _ _ _ o
o o o o o o o o o