13
11
38
100
o o o o o o o o o o o o o
o o o o o o _ o o o o o o
o o o o o _ _ _ o o o o o
o o o o o A o b o o o o o
o _ _ 1 x _ x _ x _ _ _ o
o _ _ _ 2 _ _ _ _ _ _ _ o
o o o o o B o a o o o o o
o o o o o _ _ _ o o o o o
o o o o o o C o o o o o o
o o o o o o c o o o o o o
o o o o o o o o o o o o o