10
9
o o o o o o o o o o
o - - o o o o x x o
o o o - - - - B x o
o - - - - 1 x b - o
o - - o 2 A a o - o
o - - - - - - o o o
o o o - o o o c - o
o - - - - - - C - o
