9
6
30
36
o o o o o o o o o
o o _ _ _ _ _ _ o
o x a _ _ A x _ o
o B _ _ x 2 x _ o
o _ _ _ 1 x b _ o
o o o o o o o o o