10
8
o o o o o o o o o o
o o x - x x - - c o
o B x - x - x - - o
o b A 2 a 1 x - - o
o - x x x - x - - o
o - - - - x - C - o
o - - - - - - x - o
o o o o o o o o o o
