9 
6
x x x x x x x x x
x 1 x A _ _ _ B x 
x _ x x _ x _ _ x 
x b _ _ x a _ 2 x 
x _ _ _ _ _ _ _ x
x x x x x x x x x