7
12
31
35
o o o o o o o
o o o o o o o
o o _ _ _ o o
o o _ x _ o o
o o _ _ _ o o
o o _ 1 c o o
o _ _ b _ _ o
o _ A 2 _ _ o
o _ _ _ _ _ o
o _ _ _ _ _ o
x a B _ _ C o
o x o o o o o