8
8
o o o o o o o o
o _ _ _ _ _ o o
o _ _ _ _ _ _ o
o o _ _ 1 _ _ o
x _ 2 _ _ B _ o
o _ _ a A _ _ o
o b _ _ _ _ _ o
o o o o o o o o
