11
6
100
100
o o o o o o o o o o o
o _ _ _ _ o _ b _ c o
x C 2 _ _ o _ _ _ _ o
o _ x _ _ _ _ A B _ o
o _ _ a _ o _ 1 _ _ o
o o o o o o o o o o o