10
6
17
100
x x x x x x x x x x
x b _ _ _ a _ _ _ x 
x C _ _ 1 2 _ c _ x 
x _ _ _ _ _ _ _ _ x 
x _ _ A _ _ _ _ B x
x x x x x x x x x x