9
10
o x x x x x x x x
o - - x - x - - o
o - x x - C x - o
o x - b 1 x - - o
o - - x - o x - o
o - - x - 2 x a o
o x - B - x - - o
o - - x - - x - o
o c - x - - A - o
x x x x x x x x o