7
5
o o x o x o o
o x B x a x o
x A _ 2 1 _ x
o x b x _ x o
o o x o x o o