11
9
20
25
o o o o o o o o o o o
o o o b o o o _ o o o
o o x _ o o o _ x o o
o _ _ _ _ 2 _ A _ _ o
o o o _ x B x _ o o o
o x a _ _ _ _ 1 _ x o
o o x _ o o o _ x o o
o o o x o o o _ o o o
o o o o o o o o o o o
