8
7
26
31
o x o o o o o o
x A o o o o B o
o _ x _ o o b o
x _ _ 1 _ a _ o
o x o 2 x _ o o
o o o _ _ _ o o
o o o o o o o o
