9
10
100
100
o x x x x x x x x
o _ _ x _ x _ _ o
o _ x x _ C x _ o
o x _ b 1 x _ _ o
o _ _ x _ o x _ o
o _ _ x _ 2 x a o
o x _ B _ x _ _ o
o _ _ x _ _ x _ o
o c _ x _ _ A _ o
x x x x x x x x o