8
9
30
40
o o o o o o o o
o o o _ _ _ B o
o _ _ _ _ _ _ o
o _ _ _ _ _ o o
o _ o x _ _ o o
o _ _ o o a o o
x _ 2 _ o A o o
o 1 _ _ _ _ o o
o o x o o o o o