8
9
x x x x x x x x 
x _ _ _ _ _ _ x 
x _ _ _ 1 _ C x 
x B _ _ A _ _ x 
x x x x x x x x 
o x _ 2 o _ x o 
o x _ a o _ x o 
o x _ _ _ _ x o
o x x x x x x o