10
6
70
84
o o o o o o o o o o
o _ _ x x o x B _ o
x a 1 _ _ 2 A x _ o
x _ _ x _ o x b _ o
o o o o _ _ _ _ x o
o o o o x o o o o o
