10
7
x x x x x x x x x x 
x _ _ _ 1 x _ b o x
x _ x x o x x _ _ x
x _ x _ A x c a _ x
x _ B _ _ x _ o _ x
x _ _ _ C x _ 2 _ x
x x x x x x x x x x 
