7
7
10
100
x x x x x x x
x o x _ o o x
x x o a b o x
x 1 A 2 _ o x
x o x _ o x x
x o o B o o x
x x x x x x x
