9
7
x x x x x x x x x 
x _ _ 1 x _ c _ x
x _ _ _ x _ b _ x
x _ _ A x _ a _ x
x B _ _ x _ _ _ x
x _ _ C x _ 2 _ x
x x x x x x x x x 
