12
7
29
100
o o o o o o o o o o o o
o - - - 2 - - - - - - o
o - B - - - - x b - - o
o C x - - - - - - c - o
o - A - - - a - - - - o
o - - 1 - - - - - - - o
o o o o o o o o o o o o
