10
7
x x x x x x x x x x 
x _ _ _ 1 x _ _ _ x
x _ _ _ _ x _ _ _ x
x _ _ _ A x _ 2 _ x
x _ B _ _ x _ _ _ x
x _ _ _ C x _ _ _ x
x x x x x x x x x x 
