11
7
ooooooooooo
o---2-----o
o-B-----b-o
oCx------co
o-A---a---o
o--1------o
ooooooooooo
